aminoglycoside	Ami
bacitracin	Other
beta-lactam	Beta
bleomycin	Other
carbomycin	Other
chloramphenicol	Cho
fosfomycin	Other
fosmidomycin	Other
fusaric-acid	Other
fusidic-acid	Other
kasugamycin	Other
macrolide-lincosamide-streptogramin	MLS
multidrug	Multi
polymyxin	Poly
puromycin	Other
quinolone	Qui
rifamycin	Rif
spectinomycin	Other
sulfonamide	Sul
tetracenomycin_C	Other
tetracycline	Tet
trimethoprim	Trim
unclassified	Other
vancomycin	Van
